BBBBBBBBBBBBBBBBBBBBBBBBBBBBBBBBBBBBBBBB
BGGBGGBBBBBBBBGGGBBGGGIBBBIGGBGGGGGGBGGB
BGBBBBGBBGGBGBGGBBBGBGBBBGGBBBGIGGBGBGGB
BGBCCCCCCBGBBGBGBBBBBGGBCCCCCCCCCIBIBIGB
BGBCRRRRCGBBCCCCCCCCGGGBCRRRRRRRCCCCCCCB
BGGCRPGRCGGGCRRRRRRCBGGBCRIBIBIRRRRRRRCB
BBBCRGGRCCCCCRCCCCRCBGGBCRBBBBBRGGBGBRCB
BGGCRGIRRRRRRRCBBCRCBGGBCRGGGGGRGBBGBRCB
BBBCRRRRGBGGGRCGBCRCBBBBCRGGIGGRGBBGBRCB
BGGCCCRIGGBGIRCCCCRCCCCCCRGGGGGRGBBGBRCB
BGBGGCRRRRRRRRRRRRRRRRRRRRPGIGGRRRRRRRCB
BGBBGCRIRCCCCCCCCCCCCCCCCRGBGGGRIBGGBRCB
BGBBCCRIRCBGGGGGBBBBBBGGCRBBBBBRGBGGBRCB
BBBICRRRRCBGGBBBBBBBBGGGCRIBIBIRGBGGBRCB
BBBBCRIIRCGBCCGGGGGGGGBGCRRRRRRRBBGBBRCB
BGGBCRBBRCBBCRRRCGGBBGBGCCCCCCIRIGGBIRCB
BBGBCRBBRCBBCRGRBBBBBGBGGGGBGGCRRRRRRRCB
BGCCCRIIRCBBCRIRBBBBBGGGBBBBBGCRGCCCCCCB
BGCRRRRRRCBBCRGRRRRRBGBGGCCCGGCRRPGBGGGB
BBCRCCCCCCBBCRIRGBBBBGBGGCRCGGCCRGGBBGGB
BBCRCGGBBGBGCRGRRRRRGGBGBCRCBBBCRCGGBGGB
BBCRCBBBBBBGCRIRGGBBBGBGBCRCGBBCRCGIBGIB
BBCRCCCCCCCCCRGRGCCCCCCCCCRCCCCCRCCCCCCB
BBCRRRRRRRRRRRRRRRRRRRRRRRRRRRRRRRRRRRCB
BBCCRPBIBIGIGIGIGIGIGIGIGIGIGIGIRCCBBRCB
BGGCRRRRRRRRRRRRRRRRRRRRRRRRRRRRRCIBBRCB
BGGCRCCCCRBRCCCCCCCCCCCCCCCCCCCCRCBGBRCB
IGGCRCGGCRIRCGGIGIGIGBBBGGGBBBBCRCBGBRCB
BBBCRCGGCRBRCBGGBBBBBBBBBBGGGGGCRCBGBRCB
BGBCRCGGCRIRCGCCCCCCCCCCCCBIGGGCRCIGBRCB
BGBCRCGBCRGRCBCRRRRRRRRRRCBGBBGCRCCGBRCB
BGBCRCGGCCBCCBCRBBRBBRBBRCBICCGCRRCGBRCB
BGGCRCGBBBBBBBCRBBRBBRBBRCGGCRGGBRCGBRCB
BGBCRCCCCCCCCCCRBBRBBRBPRCCCCRIBBRCBBRCB
BGGCRBRRRRRRRRRRRRRRRRRRRRRRRRRRRRCBBRCB
BGGCRIRCCCCCCCCRCCCCCCCCCCCCCRCCCRGPBRCB
BGBCRRRCGGBGGGCRCBBBBGIGGGGGCRCGCRRRRRCB
BGGCCCCCGBBBBGCRCBGGBBGBBBGGCRCBCCCCCCCB
BGGBBGGBIBBBBGCCCBGGGGGGGGBBCCCGGBBBBGGB
BBBBBBBBIBBBBBBBBBBBBBBBBBBBBBBBBBBBBBBB
