BBBBBBBBBBBBBBBBBBBBBBBBBBBBBBBBBBBBBBBB
BGGBGGBBBBBBBBGGGBBGGGIBBBIGGBCCCGGGBGGB
BGBBPBGCCGGBGCCCBBBGBGBBBGGBBBCRCGBGBGGB
BGBCCCCRCBGBBCRCBBBBBGGBCCCCCCCRCIBIBIGB
BGBCRRRRCGBBCCRCCCBGGGGBCRRRRRRRCCBCBCGB
BGGCCCCRCGGGCRRRRCGBBGGBCRIBIBIRCBBRRRCB
BBBBGCCRCCCCCRCCCCGBBGGBCRBBBBBRCGBGBRCB
IGGCCCRRRRRRRRCBBGGBBGGBCRGGGGGRCBBGBRCB
BBBCRRRIGGGGGRCGBBGBBBBBCRGGIGGRCBBGBRCB
BGGCCCRGGGGGIRCCCCCCCCCCCRGGGGGRCBBGBRCB
BGBGGCRRRRRRRRRRRRRRRRRRRRPGIGGRRRRRRRIB
BGBBGCCCRCCCCCCCCCCCCCCCCRGBGGGRCBCCBCIB
BGBBCCCCRCBGGGGGBBBBBBGGCRBBBBBRCBIGBRCB
BBGBCRRRRCBGBBBBBBBBGGGGCRIBIBIRCBGGBRCB
IBBBCRIIRCGBCCCCCCCCCCBGCRRRRRRRBBGBBRCB
IGGBCRBBRCCBCRRRRRRRRCBGCCCCCCGRCGGBIRCB
BBGBCRBBRRCBCRGRBBBBBCBGGGGBGGCRCGIBBRCB
BGCCCRIIRCCBCRIRBBBBBCCCBBBBBGCRCCBBBGGB
BGCRRRRRRCBBCRGRRRRRRCBCGBGBGGCRRPBBGGGB
BBCRCCCCCCBBCRIRGBBBBCBCGBRBGGCCRCBBBGGB
BBCRBGGBBGBGCRGRRRRRRCBCGBRGBBBCRCGGBGGB
BBCRBBBBBBBGCRIRGGBBBCBCGGRGGBBCRCGIBGIB
BBCRBCCCCCCCCRGRCCCCCCCCCCRCCCCCRCBCCCCB
BBCRRRRRRRRRRRRRRRRRRRRRRRRRRRRRRRRRRRCB
BBCGRIBIBIGIGIGIGIGIGIGIGIGIGIGIRCBBBRCB
BGCRRRRRRRRRRRRRRRRRRRRRRRRRRRRRRCIBBRCB
BGCCRPCCCRBRCCCCCCCCCCCCCCCCCCCCRCBGBRCB
IGGCRCGGCRIRCGGIGIGIGBBBGGGBBBBCRCBGBRCB
BBBCRCGGCRBRCBGGBBBBBBBBBBGGGGGCRCBGBRCB
BGBCRCGGCRIRCGCCCCCCCCCCCCBIGGGCCCIGBRBB
BGBCRCGBCRBRCBCRRRRRRRRRRCBGBBGBBBBGBRBB
BGBCRCGGCCCCCBCRBBRBBRBBRCBICCCGCCCGBRBB
BGGCRCGBBBBBBBCRBBRBBRBBRCGGCRCGCRCGBRBB
BGBCRCCCCCCCCCCRBBRBBRBPRCCCCRCCCRCBBRCB
BGGCRCRRRRRRRRRRRRRRRRRRRRRRRRRRRRCBBRCB
BCCCRIRCCCCCCCCRCCCCCCCCCCCCCRCCCRCBBRCB
BCRRRRRBGGBGGGCRCBBBBGIGGGGGCRCGCRRRRRCB
BCCCCCCBGBBBBGCRCBGGBBGBBBGGCRCBCCCCBCCB
BGGBBGGBIBBBBGCCCBGGGGGGGGBBCCCGGBBBBGGB
BBBBBBBBIBBBBBBBBBBBBBBBBBBBBBBBBBBBBBBB