BBBBBBBBBBBBBBBBBBBBBBBBBBBBBBBBBBBBBBBB
BGGBGGBBBBBBBBGGGBBGGGIBBBIGGBGGGGGGBGGB
BGBBBBGBBGGBGBGGBBBGBGBBBGGBBBGIGGBGBGGB
BGBCCCCCCBGBBGBGBBBBBGGBCCCCCCCCCIBIBIGB
BGBCRRRRCGBBCCCCCCCCGGGBCRRRRRRRCCCCCCCB
BGGCRPGRCGGGCRRRRRRCBGGBCRIBIBIRRRRRRRCB
BBBCRGGRCCCCCRCCCCRCBGGBCRBBBBBRGGBGBRCB
IGGCRGIRRRRRRRCBBCRCBGGBCRGGGGGRGBBGBRCB
BBBCRRRRGBGGGRCGBCRCBBBBCRGGIGGRGBBGBRCB
BGGCCCRIGGBGIRCCCCRCCCCCCRGGGGGRGBBGBRCB
BGBGGCRRRRRRRRRRRRRRRRRRRRPGIGGRRRRRRRCB
BGBBGCGIRCCCCCCCCCCCCCCCCRGBGGGRIBGGBRCB
BGBBCCGIRCBGGGGGBBBBBBGGCRBBBBBRGBGGBRCB
BBGBCRRRRCBGBBBBBBBBGGGGCRIBIBIRGBGGBRCB
IBBBCRIIRCGBCCCCCCCCCCBGCRRRRRRRBBGBBRCB
IGGBCRBBRCCBCRRRRRRRRCBGCCCCCCIRIGGBIRCB
BBGBCRBBRRCBCRGRBBBBBCBGGGGBGGCRRRRRRRCB
BGCCCRIIRCCBCRIRBBBBBCCCBBBBBGCRGGCCCCCB
BGCRRRRRRCBBCRGRRRRRRCBCGBGBGGCRRPCBGGGB
BBCRCCCCCCBBCRIRGBBBBCBCGBRBGGCCRCCBBGGB
BBCRBGGBBGBGCRGRRRRRRCBCGBRGBBBCRCGGBGGB
BBCRBBBBBBBGCRIRGGBBBCBCGGRGGBBCRCGIBGIB
BBCRBCCCCCCCCRGRCCCCCCCCCCRCCCCCRCCCCCCB
BBCRRRRRRRRRRRRRRRRRRRRRRRRRRRRRRRRRRRCB
BBCGRIBIBIGIGIGIGIGIGIGIGIGIGIGIRCCBBRCB
BGCPRRRRRRRRRRRRRRRRRRRRRRRRRRRRRCIBBRCB
BGCCRCCCCRBRCCCCCCCCCCCCCCCCCCCCRCBGBRCB
IGGCRCGGCRIRCGGIGIGIGBBBGGGBBBBCRCBGBRCB
BBBCRCGGCRBRCBGGBBBBBBBBBBGGGGGCRCBGBRCB
BGBCRCGGCRIRCGCCCCCCCCCCCCBIGGGCRCIGBRCB
BGBCRCGBCRBRCBCRRRRRRRRRRCBGBBGCRCCGBRCB
BGBCRCGGCCCCCBCRBBRBBRBBRCBICCCCRRCGBRCB
BGGCRCGBBBBBBBCRBBRBBRBBRCGGCRGGBRCGBRCB
BGBCRCCCCCCCCCCRBBRBBRBPRCCCCRIBBRCBBRCB
BGGCRBRRRRRRRRRRRRRRRRRRRRRRRRRRRRCBBRCB
BCCCRIRCCCCCCCCRCCCCCCCCCCCCCRCCCRCPBRCB
BCBGRRRCGGBGGGCRCBBBBGIGGGGGCRCGCRRRRRCB
BCCCCCCCGBBBBGCRCBGGBBGBBBGGCRCBCCCCCCCB
BGGBBGGBIBBBBGCCCBGGGGGGGGBBCCCGGBBBBGGB
BBBBBBBBIBBBBBBBBBBBBBBBBBBBBBBBBBBBBBBB
