BBBBBBBBBBBBBBBBBBBBBBBBBBBBBBBBBBBBBBBB
BGGBGGBBBBBBBBGGGBBGGGIBBBIGGBCCCGGGBGGB
BGBBCBGCCGGBGCCCBBBGBGBBBGGBBBCICGBGBGGB
BGBCPCCCCBGBBCBCBBBBBGGBCCCCCCCCCIBIBIGB
BGBCRRRRCGBBCCCCCCBGGGGBCRRRRRRRCCBCBCGB
BGGCRCCRCGGGCRRRRRRBBGGBCRIBIBIRRRBRRRCB
BBBBRCCRCCCCCRCCCCRBBGGBCRBBBBBRCGBGBRCB
IGGCRCIRRRRRRRCBBGRBBGGBCRGGGGGRCBBGBRCB
BBBCRRRRGGGGGRCGBBRBBBBBCRGGIGGRCBBGBRCB
BGGCCCRGGGGGIRCCCCRCCCCCCRGGGGGRCBBGBRCB
BGBGGCRRRRRRRRRRRRRRRRRRRRPGIGGRRRRRRRIB
BGBBGCCCRCCCCCCCCCCCCCCCCRGBGGGRIBCCBRIB
BGBBCCCCRCBGGGGGBBBBBBGGCRBBBBBRCBGGBRCB
BBGBCRRRRCBGBBBBBBBBGGGGCRIBIBIRCBGGBRCB
IBBBCRIIRCGBCCCCCCCCCCBGCRRRRRRRBBGBBRCB
IGGBCRBBRCCBCRRRRRRRRCBGCCCCCCIRIGGBIRCB
BBGBCRBBRRCBCRGRBBBBBCBGGGGBGGCRRRRRRRCB
BGCCCRIIRCCBCRIRBBBBBCCCBBBBBGCRCCBBBGGB
BGCRRRRRRCBBCRGRRRRRRCBCGBGBGGCRRPCBGGGB
BBCRCCCCCCBBCRIRGBBBBCBCGBRBGGCCRCBBBGGB
BBCRBGGBBGBGCRGRRRRRRCBCGBRGBBBCRCGGBGGB
BBCRBBBBBBBGCRIRGGBBBCBCGGRGGBBCRCGIBGIB
BBCRBCCCCCCCCRGRCCCCCCCCCCRCCCCCRCBCCCCB
BBCRRRRRRRRRRRRRRRRRRRRRRRRRRRRRRRRRRRCB
BBCGRIBIBIGIGIGIGIGIGIGIGIGIGIGIRCBBBRCB
BGCBRRRRRRRRRRRRRRRRRRRRRRRRRRRRRCIBBRCB
BGCCRPCCCRBRCCCCCCCCCCCCCCCCCCCCRCBGBRCB
IGGCRCGGCRIRCGGIGIGIGBBBGGGBBBBCRCBGBRCB
BBBCRCGGCRBRCBGGBBBBBBBBBBGGGGGCRCBGBRCB
BGBCRCGGCRIRCGCCCCCCCCCCCCBIGGGCRCIGBRBB
BGBCRCGBCRBRCBCRRRRRRRRRRCBGBBGBRBBGBRBB
BGBCRCGGCCCCCBCRBBRBBRBBRCBICCCGRRCGBRBB
BGGCRCGBBBBBBBCRBBRBBRBBRCGGCRCGCRCGBRBB
BGBCRCCCCCCCCCCRBBRBBRBPRCCCCRCCCRCBBRCB
BGGCRCRRRRRRRRRRRRRRRRRRRRRRRRRRRRCBBRCB
BCCCRIRCCCCCCCCRCCCCCCCCCCCCCRCCCRCPBRCB
BCBBRRRBGGBGGGCRCBBBBGIGGGGGCRCGCRRRRRCB
BCCCCCCBGBBBBGCRCBGGBBGBBBGGCRCBCCCCBCCB
BGGBBGGBIBBBBGCCCBGGGGGGGGBBCCCGGBBBBGGB
BBBBBBBBIBBBBBBBBBBBBBBBBBBBBBBBBBBBBBBB
