BBBBBBBBBBBBBBBBBBBBBBBBB
BCCCCCCCCCCCCCCCCCCCCCCCB
BRRRRRRRRRRRRRRRRRRRRRRRB
BGRGGRGGRIGIRGGGGGGGGGPRB
BGRGGRGGRGGGRGGGGGGGGGGRB
BGRRRRGGRGGGRGGGGGGGGGGRB
BGRGGRGGRGGGRGGGBPBGGGGRB
BGRGPRGGRGGGRGGGBRBGGGGRB
BGRRRRRRRRRRRGGGGRGGGGGRB
BGGGGRGGBBGGRGGGGRGGGGGRB
BGGGGRGGBBGGRRRRRRRRRRRRB
BRRRGRGGGGGGRGGGGGGGGGGRB
BRBRGRGBBIGGRGGGGGGGGGGRB
BRBRGRGBBIBGRGGIGIGIGGGRB
BRBRRRGBBIBGRGGGGGGGGGGRB
BRBRGRGGGGGGRGGGGGGGGGGRB
BRRRGRRRRRRRRGGGPRRRRRRRB
BGGGPRGGGGGPRGGGGRBBRBBRB
BGBGGRGGGGGGRGGGGRBBRBBRB
BGBGGRGIIGGBRGGGGRRRRRRRB
BGBGGRGGGGGBRGGGGRIBRGGRB
BGGGGRGBGBBIRIGGGRBIRGGRB
BRRRRRRRRRRRRRRRRRRRRRRRB
BCCCCCCCCCCCCCCCCCCCCCCCB
BBBBBBBBBBBBBBBBBBBBBBBBB