BBBBBBBBBBBBBBBBBBBBBBBBBBBBBBBBBBBBBBBB
BGGBGGBBBBBBBBGGGBBGGGIBBBIGGBGGGGGGBGGB
BGBBBBGBBGGBGBGGBBBGBGBBBGGBBBGIGGBGBGGB
BGBCCCCCCBGBBGBGBBBBBGGBCCCCCCCCCIBIBIGB
BGBCRRRRCGBBCCCCCCCCGGGBCRRRRRRRCCCCCCCB
BGGCRPGRCGGGCRRRRRRCBGGBCRIBIBIRRRRRRRCB
BBBCRGGRCCCCCRCCCCRCBGGBCRBBBBBRGGBGBRCB
IGGCRGIRRRRRRRCBBCRCBGGBCRGGGGGRGBBGBRCB
BBBCRRRRGBGGGRCGBCRCBBBBCRGGIGGRGBBGBRCB
BGGCCCRIGGBGIRCCCCRCCCCCCRGGGGGRGBBGBRCB
BGBGGCRRRRRRRRRRRRRRRRRRRRPGIGGRRRRRRRCB
BGBBGCGIRCCCCCCCCCCCCCCCCRGBGGGRIBGGBRCB
BGBBCCGIRCBGGGGGBBBBBBGGCRBBBBBRGBGGBRCB
BBGBCRRRRCBGBBBBBBBBBGGGCRIBIBIRGBGGBRCB
IBBBCRIIRCGBCCCCCGGBBGBGCRRRRRRRBBGBBRCB
IGGBCRBBRCBBCRRRCGGBBGBGCCCCCCIRIGGBIRCB
BBGBCRBBRCBBCRGRBBBBBGBGGGGBGGCRRRRRRRCB
BGCCCRIIRCBBCRIRBBBBBGGGBBBBBGCRGCCCCCCB
BGCRRRRRRCBBCRGRRRRRBGBGGCCCGGCRRPGBGGGB
BBCRCCCCCCBBCRIRGBBBBGBGGCRCGGCCRGGBBGGB
BBCRCGGBBGBGCRGRRRRRGGBGBCRCBBBCRCGGBGGB
BBCRCBBBBBBGCRIRGGBBBGBGBCRCGBBCRCGIBGIB
BBCRCCCCCCCCCRGRCCCCCCCCCCRCCCCCRCCCCCCB
BBCRRRRRRRRRRRRRRRRRRRRRRRRRRRRRRRRRRRCB
BBCCRPBIBIGIGIGIGIGIGIGIGIGIGIGIRCCBBRCB
BGGCRRRRRRRRRRRRRRRRRRRRRRRRRRRRRCIBBRCB
BGGCRCCCCRBRCCCCCCCCCCCCCCCCCCCCRCBGBRCB
IGGCRCGGCRIRCGGIGIGIGBBBGGGBBBBCRCBGBRCB
BBBCRCGGCRBRCBGGBBBBBBBBBBGGGGGCRCBGBRCB
BGBCRCGGCRIRCGCCCCCCCCCCCCBIGGGCRCIGBRCB
BGBCRCGBCRBRCBCRRRRRRRRRRCBGBBGCRCCGBRCB
BGBCRCGGCCCCCBCRBBRBBRBBRCBICCCCRRCGBRCB
BGGCRCGBBBBBBBCRBBRBBRBBRCGGCRGGBRCGBRCB
BGBCRCCCCCCCCCCRBBRBBRBPRCCCCRIBBRCBBRCB
BGGCRBRRRRRRRRRRRRRRRRRRRRRRRRRRRRCBBRCB
BGGCRIRCCCCCCCCRCCCCCCCCCCCCCRCCCRCPBRCB
BGBCRRRCGGBGGGCRCBBBBGIGGGGGCRCGCRRRRRCB
BGGCCCCCGBBBBGCRCBGGBBGBBBGGCRCBCCCCCCCB
BGGBBGGBIBBBBGCCCBGGGGGGGGBBCCCGGBBBBGGB
BBBBBBBBIBBBBBBBBBBBBBBBBBBBBBBBBBBBBBBB
