BBBBBBBBBBBBBBBBBBBBBBBBB
BCCRCCCCCCCCCCCCCCCCCCCCB
BRRRRRRRRRRRRRRRRRRRRRRRB
BRIRIRIRPGGGGGBRBGRBPBRCB
BRGRGRGRBGGGGGBRBGRBGBRCB
BRIRIRIRBGGBGGBRBGRBGBRCB
BRRRRRRRBGGBGGBRBBBBGBRCB
BRIRPRIRBGBBBBBRBGGGGBRCB
BRGRGRGRBGRRRRRRBGGGGBRCB
BRGRGRGRBBBRPBBRBBBGGGRCB
BRIRIRIRBGBRBGGRRRRGIBRCB
BRRRRRRRBBBRBGGRBBBGIBRCB
BRGGBBBBGGGGGGGRBGGGIBRCB
BRGGGGGGGGGGGGGRBGGGGGRCB
BRPBBBPGGBBBBBBRBGGBBBRCB
BRRRRRRRRRRRRRRRRRRRRRRCB
BRBGBRBGGGBRGIGRGBRBBBRCB
BRBGBRBGGGBRBIBRGBRGBGRCB
BRBGBRBGGGBRPIGRBGRRRRRCB
BRBGGGGGGGBRRRRRBGRBGBRCB
BRBGGGGGGGGGGGBRBGRBGBRCB
BRBBBBBBBBBBBBBRBBRPGBRCB
BRRRRRRRRRRRRRRRRRRRRRRCB
BCCCCCCCCCCCCCCCCCCCCCCCB
BBBBBBBBBBBBBBBBBBBBBBBBB
